########## ###########
#        #     #     #
# ###### ##### ### ###
# #    #       #     #
# # ## ########### ###
# #  # #         #   #
### ## ### ##### ### #
#    #     # #   #   #
#### ####### ### ### #
#B   #       #       #
##### ####### ####### #
#         #     #     #
# ####### ##### # ### #
# #     #   #   # #   #
# # ### ### ### ### ###
#   #     #   #       #
### ####### ######### #
#           #         #
######################A